//float x float y float c float moveY float movex sf::Int8 type float width float height int heal int shooter

//boss
2500, 500, 0, 0, 0, 8, 260, 145, 30, 1
//random enemy
{
2000, 200, -0.002, 0, 2, 4, 35, 35, 3, 0
900, 235, -0.03, 0, 1.8, 5, 35, 35, 3, 0
900, 300, -0.01, 0, 1.7, 6, 35, 35, 3, 0
1500, 500, 0, 1, 1, 6, 35, 35, 1, 0
}
//make ground
0, 900, 0, 0, 1, 3, 384, 132, 1000, 0
384, 980, 0, 0, 1, 2, 384, 40, 1000, 0
768, 980, 0, 0, 1, 1, 384, 40, 1000, 0
1152, 900, 0, 0, 1, 3, 384, 132, 1000, 0
1536, 980, 0, 0, 1, 1, 384, 40, 1000, 0
1920, 900, 0, 0, 1, 3, 384, 132, 1000, 0
2304, 980, 0, 0, 1, 2, 384, 40, 1000, 0
2688, 800, 0, 0, 1, 0, 384, 270, 1000, 0
3072, 980, 0, 0, 1, 1, 384, 40, 1000, 0
3456, 980, 0, 0, 1, 1, 384, 40, 1000, 0
3840, 980, 0, 0, 1, 2, 384, 40, 1000, 0
4224, 900, 0, 0, 1, 3, 384, 132, 1000, 0
4608, 980, 0, 0, 1, 2, 384, 40, 1000, 0
4992, 900, 0, 0, 1, 3, 384, 132, 1000, 0
5376, 900, 0, 0, 1, 3, 384, 132, 1000, 0
5760, 980, 0, 0, 1, 2, 384, 40, 1000, 0
6144, 800, 0, 0, 1, 0, 384, 270, 1000, 0
6528, 980, 0, 0, 1, 2, 384, 40, 1000, 0
6912, 800, 0, 0, 1, 0, 384, 270, 1000, 0
7296, 800, 0, 0, 1, 0, 384, 270, 1000, 0